MqttTelemetry	KEYWORD1
CircularBuffer	KEYWORD1
SchemaValidator	KEYWORD1
StorageManager	KEYWORD1

begin	KEYWORD2
update	KEYWORD2
connect	KEYWORD2
disconnect	KEYWORD2
subscribe	KEYWORD2
unsubscribe	KEYWORD2
isConnected	KEYWORD2
getStatus	KEYWORD2
getStats	KEYWORD2
loadSchema	KEYWORD2
validateMessage	KEYWORD2
flushBuffer	KEYWORD2
mountSD	KEYWORD2
unmountSD	KEYWORD2
isSDMounted	KEYWORD2
getSDFreeSpace	KEYWORD2
getSDTotalSpace	KEYWORD2

STATUS_INITIALIZING	LITERAL1
STATUS_WIFI_CONNECTING	LITERAL1
STATUS_MQTT_CONNECTING	LITERAL1
STATUS_RUNNING	LITERAL1
STATUS_ERROR	LITERAL1
STATUS_BUFFER_FULL	LITERAL1
STATUS_SD_ERROR	LITERAL1
